##############################################################################
##############################################################################
##############################################################################
##############################################################################
##############################################################################
######..........########################.................*********......######
######..............*******..............................*********......######
######..............*******................#####..###########..###############
#########**##################..#############...#..#......####...........######
#########..##################**##########..##################...........######
######.....................******....******#0........*******#...........######
######.....................******....******#.........*******#****.......######
######..############..###################..############..####****.......######
######....******...#..###################..############..####**#######..######
######....******...#*****........................#.................#****######
####################*****........................#.................#****######
######...................#####################################################
######...................#####################################################
##############################################################################
##############################################################################
##############################################################################
##############################################################################
##############################################################################
